AJCJC | LZPD-LDYFDZIIPQF | ZEWPBYD ICCUPQFB | ICBBZFC PQBUDJKUYD YD ICQUYD
QUEUE | PAIR-PROGRAMMING | ADVISOR MEETINGS | MESSAGE INSTRUCTOR OR MENTOR





A B C D E F G H I J K L M 
N O P Q R S T U V W X Y Z

A = Q
B = S
C = E
D = R
E = D
F = G
G = 
H =
I = M
J = U
K = C
L = P
M =
N =
O =
P = I
Q = N
R =
S =
T =
U = T
V =
W = V
X =
Y = O
Z = A


